D                                          C
D                                          C
D                                          C
D                                          C
DYYYYYZ    XYYYYYYYYYYYYYYYYYYYYYYYYYYYYYYYC
D                                          C
D                                          C
D                                          C
D                                          C
D                                          C
DYYYZ                                      C
D                                          C
D                                          C
D                                          C
D      XYYZ                                C
D                                          C
D                                          C
D                                          C
D               XYYYYYYYYZ                 C
D                                          C
D                                          C
D                                          C
PPPPPPPPPPPPPPPPB        APPPPPPPPPPPPPPPPPP
                D        C
                D        C
                D        C
                D        C
PPPPPPPPPPPPPPPPPPPPPPPPPPPPPPPPPPPPPPPPPPPP



--------------------------------------------