   
   

                           RRRRRRRRRRRRRR
                  AB  F               
                  CD APPB           
               PPPCD C  D  E          SOQ 
                  CD C   APPB         C D
                  CD C   C  DXYZ   SOQC D
                  CD C   C  D      C  C D
-----------------------------------------