6                                          4
6                                          4
6                                          4
6                                          4
6                                          4
6                                          4
6                                          4
6                                          4
6                                          4
6                                          4
6                                          4
6                                          4
6                                          4
6                                          4
88888888888888889                          4
                6                   (-------
                6               (-----
                6           (-----
                6        (-----
--------------------------------------------




--------------------------------------------